ypxibibjnp	рефлектор
xsrcqqcdsr	катадиоптрический
qsiekkycvg	катадиоптрический
zihkzofgmd	рефрактор
wxprqsbhfj	рефрактор
lhidhtpqdc	рефлектор
uzrznuhcta	рефрактор
aveuwsehqz	рефлектор
fttgrixoto	катадиоптрический
xcgkawtecq	рефлектор
fwuqnnhncs	рефрактор
vbildjxkii	рефлектор
hjuoyxrzxa	катадиоптрический
eoaosgoled	рефлектор
rdlzxveesp	рефрактор
hcoqcjnccc	катадиоптрический
rbwhrwhnqy	рефлектор
vaatpqqwpr	рефлектор
coebcqbzjp	катадиоптрический
txxxncfksf	рефрактор
eagdplgrvc	катадиоптрический
fjbdlcftma	рефрактор
mbgkfmbxyi	рефрактор
brdcbnjgwh	рефрактор
cvlpdehlnd	рефрактор
lzxscazhvs	катадиоптрический
igbqvcmnir	рефрактор
dulkvquwhq	катадиоптрический
zzdvavxltc	рефрактор
clzxcyimbc	катадиоптрический
flvuvhyegp	катадиоптрический
qwggkfkpti	рефрактор
myiecqxwwn	рефрактор
mwcxviwasw	катадиоптрический
reyqgsvdrk	рефрактор
whqtncgsmi	катадиоптрический
suihtjxejz	рефрактор
rkhybbzqnr	катадиоптрический
yrutivyihd	рефлектор
svoktvdgii	рефрактор
hnsyhalept	катадиоптрический
brsnzgeupn	рефлектор
joanylpmdh	рефрактор
hqrwwrnscx	рефрактор
euagufwjsy	рефрактор
rpgmqeojug	рефрактор
vzxhpwmnge	катадиоптрический
rybrzrwhyg	рефрактор
nsywokigpz	рефрактор
mpxseuqwox	рефлектор
mfrbyljsrq	рефрактор
apzvszjesp	рефрактор
fnsqlkpjyk	катадиоптрический
fcvfldbaiu	катадиоптрический
ntaftexrsk	рефлектор
nfyusenvzb	катадиоптрический
cemapdbeyp	рефлектор
tkcdvyqhyv	катадиоптрический
vxondwawjl	рефрактор
umwznpwybd	рефлектор
jctsxoiofm	катадиоптрический
ixnwloywkt	рефрактор
fqvgwvuftw	катадиоптрический
ysrhlvbavp	рефрактор
qexchrvoqh	рефлектор
uneepoxuzj	катадиоптрический
payikellvd	рефрактор
zvyzasbrim	рефрактор
yangftcxko	рефрактор
yvfuyqxgdg	рефлектор
homlrdeweq	рефрактор
dlutscswnq	катадиоптрический
jlzbusvfgb	катадиоптрический
sjxodubaoz	катадиоптрический
znffwlthzu	катадиоптрический
hcexuddztm	рефлектор
gzevuxpiko	катадиоптрический
xqhibhvvor	рефрактор
utmrfhikwg	рефлектор
tzjrxdnirj	катадиоптрический
ppwdvubedh	рефрактор
judzncqagr	рефлектор
npqfwgsoqf	катадиоптрический
dmqqngxtzs	рефлектор
jmaljmdmzq	рефрактор
ikjqgxpwxa	катадиоптрический
vqykkkwuhz	рефрактор
egbfadtwnq	рефрактор
eokcrxlget	катадиоптрический
jpjnljzfiu	рефлектор
exsjxxontm	рефлектор
yiqncgrezt	катадиоптрический
qdqjmdjelf	рефлектор
rjlwcvymai	рефлектор
qkksumwxml	рефлектор
lsyokborje	катадиоптрический
xdybgtwwid	рефлектор
yfksbgmwxz	рефлектор
jwilzlkqyn	катадиоптрический
lmjosmgkhk	рефлектор
